22 12
0 286
51 52 53 0 0 0 0 0 0 0 51 52 53 0 0 96 0 0 0 41 94 0
54 55 56 0 0 0 0 0 0 59 54 55 56 0 0 81 82 82 82 83 84 85
42 57 58 0 0 0 0 0 59 59 93 57 58 0 0 0 0 0 0 0 0 0
82 83 84 85 0 0 0 0 81 82 82 82 83 84 85 0 0 0 0 0 0 0
0 0 0 0 59 42 0 0 0 0 0 0 0 0 0 0 0 41 0 0 0 0
0 0 0 0 86 87 88 0 0 96 0 0 0 0 0 86 87 88 0 0 0 0
0 0 0 0 0 0 0 0 86 87 88 0 0 41 0 0 0 0 0 0 0 0
0 48 49 50 0 0 0 0 0 0 0 0 86 87 88 0 0 0 0 0 0 0
0 45 46 47 0 0 0 0 0 0 0 0 0 0 0 0 60 61 0 0 0 0
0 43 44 0 0 0 0 0 0 42 0 0 0 0 93 59 62 63 0 0 0 0
69 69 69 69 69 0 0 69 69 69 69 69 69 69 69 69 69 69 69 69 69 69
72 72 72 72 72 39 40 72 72 72 72 72 72 72 72 72 72 72 72 72 72 72