22 12
0 286
0 0 0 0 0 0 0 0 0 0 0 0 0 0 0 0 0 0 0 0 0 0
0 0 0 0 0 0 0 0 0 51 52 53 0 0 0 0 0 0 68 69 70 0
68 69 69 70 0 0 0 0 0 54 55 56 0 86 87 88 0 0 74 75 76 0
71 72 72 73 0 86 87 88 0 0 57 58 0 0 0 0 0 0 0 0 0 0
74 75 75 76 0 0 0 0 0 86 87 88 0 0 0 0 0 0 0 0 0 0
64 65 0 0 0 51 52 53 0 0 0 0 0 0 59 0 48 49 50 0 0 0
66 67 0 0 0 54 55 56 0 0 0 0 0 0 0 0 45 46 47 0 0 0
0 48 49 50 0 0 57 58 0 0 0 0 0 0 0 0 43 44 0 0 0 0
0 45 46 47 0 86 87 88 0 0 68 69 69 69 69 69 69 70 0 0 0 0
0 43 44 0 0 0 0 0 0 0 71 72 72 72 72 72 72 73 59 0 0 0
69 69 69 70 37 37 37 37 37 37 71 72 72 72 72 72 72 77 78 69 69 69
72 72 72 73 38 38 38 38 38 38 71 72 72 72 72 72 72 72 72 72 72 72