22 12
0 286
0 0 0 0 0 0 0 0 0 0 0 0 0 0 0 0 0 0 0 0 0 0
0 0 0 0 0 0 0 0 0 0 0 0 0 0 33 33 33 33 33 33 33 33
33 0 0 0 0 0 0 0 0 0 0 0 0 36 34 34 34 34 34 34 34 34
34 35 0 0 0 0 0 0 0 0 0 0 36 34 9 9 9 9 9 9 9 9
9 34 35 33 33 33 33 33 33 33 33 36 34 9 9 9 9 9 9 9 9 9
9 9 34 34 34 34 34 34 6 34 34 34 9 9 9 9 9 9 9 9 9 9
0 0 0 0 0 0 0 0 0 0 0 0 0 0 0 0 0 0 0 0 0 0
0 0 0 0 0 0 0 0 0 0 0 0 0 0 0 0 0 0 0 0 0 0
0 0 0 0 0 0 33 33 33 33 33 0 0 0 0 0 0 0 0 0 0 0
33 33 33 33 33 36 0 0 0 0 0 35 33 33 33 33 33 33 33 33 33 33
0 0 0 0 0 0 0 0 0 0 0 0 0 0 0 0 0 0 0 0 0 0
0 0 0 0 0 0 0 0 0 0 0 0 0 0 0 0 0 0 0 0 0 0