22 12
0 286
0 0 0 0 0 0 0 0 0 0 0 0 0 0 0 0 0 0 0 0 0 0
0 0 0 0 0 0 0 0 0 0 0 0 0 0 0 0 0 0 0 0 0 0
0 0 0 0 0 0 0 0 33 33 33 33 33 33 33 33 33 0 0 0 0 0
0 0 0 0 0 0 0 36 0 0 0 0 0 0 0 0 0 35 0 0 0 0
33 33 33 33 33 33 36 0 0 0 0 0 0 0 0 0 0 0 35 33 33 33
0 0 0 0 0 0 0 0 0 0 0 0 0 0 0 0 0 0 0 0 0 0
0 0 0 0 0 0 0 0 33 33 33 33 33 33 33 33 0 0 0 0 0 0
0 0 0 0 0 0 0 36 0 0 0 0 0 0 0 0 35 0 0 0 0 0
0 0 0 0 0 0 36 0 0 0 0 0 0 0 0 0 0 35 0 0 0 0
33 33 33 33 33 36 0 0 0 0 0 0 0 0 0 0 0 0 35 33 33 33
0 0 0 0 0 0 0 0 0 0 0 0 0 0 0 0 0 0 0 0 0 0
0 0 0 0 0 0 0 0 0 0 0 0 0 0 0 0 0 0 0 0 0 0