22 12
0 286
0 0 0 0 0 0 0 0 0 0 0 0 0 0 0 0 0 0 0 0 0 0
0 0 0 0 0 0 0 0 0 0 0 0 0 0 0 0 0 0 0 0 0 0
0 0 0 0 0 0 0 0 0 0 0 0 0 0 0 0 0 0 0 0 0 0
0 0 0 0 0 0 0 0 34 34 34 34 34 6 34 34 34 0 0 0 0 0
0 0 0 0 0 0 0 34 9 9 9 9 9 9 9 9 9 34 0 0 0 0
34 34 34 34 34 34 34 9 9 9 9 9 9 9 9 9 9 9 34 34 34 34
9 9 9 9 9 9 9 9 9 9 9 9 9 9 9 9 9 9 9 9 9 9
9 9 9 9 9 9 9 9 34 34 34 34 34 34 34 34 9 9 9 9 9 9
9 9 9 9 9 9 9 34 9 9 9 9 9 9 9 9 34 9 9 9 9 9
9 9 9 9 9 9 34 9 9 9 9 9 9 9 9 9 9 34 9 9 9 9
34 34 34 34 34 34 9 9 9 9 9 9 9 9 9 9 9 9 34 34 34 34
9 9 9 9 9 9 9 9 9 9 9 9 9 9 9 9 9 9 9 9 9 9