22 12
0 286
42 0 0 0 0 0 0 45 46 47 0 0 0 0 0 0 0 0 0 0 0 0
0 0 0 0 51 52 53 43 44 0 0 0 0 0 0 0 0 0 0 0 0 0
0 0 0 0 54 55 56 0 0 0 0 0 0 0 0 0 0 0 0 0 0 0
0 0 0 0 0 57 58 0 0 0 48 49 50 0 0 0 0 0 0 0 0 0
0 0 0 0 0 0 0 0 0 0 45 46 47 0 0 0 0 0 0 0 0 0
0 0 0 0 0 0 0 0 0 0 43 44 0 0 0 0 0 0 0 0 0 0
0 0 0 0 0 0 0 0 0 0 0 0 0 0 0 0 0 0 0 0 0 0
49 50 0 0 0 0 0 0 0 0 0 0 0 0 0 0 0 0 0 0 0 0
46 47 0 0 0 0 0 0 0 0 0 0 0 0 0 0 0 0 0 0 0 0
44 0 0 0 0 0 0 0 0 0 0 0 0 0 0 0 0 0 0 0 0 0
0 0 0 0 0 0 0 0 0 0 0 0 0 0 0 0 0 0 0 0 0 0
0 0 0 0 0 0 0 0 0 0 0 0 0 0 0 0 0 0 0 0 0 0