22 12
0 286
0 0 0 0 0 0 0 0 0 0 0 0 0 0 0 0 0 0 0 0 0 0
0 0 0 0 0 21 22 0 0 0 0 0 0 0 0 0 17 0 0 0 0 0
0 0 0 0 23 24 25 26 0 0 0 0 0 0 0 0 0 0 0 15 0 0
0 0 0 0 27 28 29 30 0 0 0 0 0 0 0 0 0 0 0 15 0 0
0 0 0 0 5 31 32 17 1 0 0 0 0 0 0 0 0 0 0 16 0 0
0 0 0 0 0 0 0 0 2 0 0 0 0 0 0 0 0 0 0 16 0 0
22 0 0 0 0 0 0 0 2 0 0 0 0 21 22 0 0 0 0 16 0 0
25 26 0 0 0 0 0 0 3 0 0 0 23 24 25 26 0 0 0 16 0 0
29 30 0 0 0 0 0 0 4 0 0 0 27 28 29 30 18 0 0 16 0 0
32 17 0 0 0 0 0 0 0 0 0 0 0 31 32 17 19 0 0 16 0 12
0 0 0 0 0 0 0 0 0 0 0 0 0 0 0 0 0 0 0 0 0 0
0 0 0 0 0 0 0 0 0 0 0 0 0 0 0 0 0 0 0 0 0 0