22 12
0 286
0 0 0 0 0 0 0 0 0 0 0 0 0 0 0 0 0 0 0 0 0 0
0 0 21 22 0 0 0 0 0 0 0 0 0 0 0 0 0 0 0 0 21 22
0 23 24 25 26 0 0 0 0 0 17 0 0 1 0 0 0 0 0 23 24 25
0 27 28 29 30 0 0 0 0 0 0 0 0 2 0 0 0 0 0 27 28 29
0 5 31 32 0 0 0 0 0 0 0 0 0 2 0 0 0 0 0 17 31 32
0 0 0 0 15 0 0 0 0 18 0 0 0 3 0 0 0 0 0 0 0 0
0 21 22 0 15 0 0 0 0 19 0 0 0 4 0 17 0 0 0 0 0 0
23 24 25 26 16 0 0 0 0 0 0 0 0 0 0 0 0 0 0 0 0 0
27 28 29 30 16 0 0 0 0 0 0 0 0 0 0 0 0 0 0 18 0 0
0 31 32 0 16 0 0 0 0 0 0 0 0 0 0 0 0 0 0 19 12 0
0 0 0 0 0 0 0 0 0 0 0 0 0 0 0 0 0 0 0 0 0 0
0 0 0 0 0 0 0 0 0 0 0 0 0 0 0 0 0 0 0 0 0 0