22 12
0 286
0 0 0 0 0 0 0 0 0 0 0 0 0 0 0 0 0 0 0 0 0 0
69 69 69 70 0 0 0 0 0 0 0 0 0 86 87 88 0 0 0 0 0 0
75 75 75 76 0 0 0 81 82 83 84 85 0 0 0 0 0 0 0 0 0 0
0 0 0 0 0 0 0 0 0 0 0 0 0 0 0 0 0 0 0 0 0 0
0 0 0 0 86 87 88 0 0 0 0 0 0 0 0 0 0 0 0 0 0 0
0 0 0 0 0 0 0 0 0 0 0 0 0 0 0 0 0 0 0 123 0 0
0 0 0 0 0 68 69 69 69 69 69 69 70 0 0 0 0 118 119 120 121 122
0 0 0 0 0 71 72 72 72 72 72 72 73 0 0 0 0 113 114 115 116 117
0 0 0 0 59 71 72 72 72 72 72 72 73 0 59 0 0 108 109 110 111 112
0 0 0 59 59 71 72 72 72 72 72 72 73 0 59 59 0 103 104 105 106 107
69 69 69 69 79 80 72 72 72 72 72 72 77 78 69 69 69 69 69 69 69 69
72 72 72 72 72 72 72 72 72 72 72 72 72 72 72 72 72 72 72 72 72 72